044444444440
510000000005
510111011115
510100020005
510101100105
510001001105
501111001005
530001211015
510121010015
510000000115
511111111115
044444444440