044444444440
511100000115
510001123015
510101000115
513002010105
500101030005
501101010015
500101210115
511100000105
510001100115
500111001115
044444444440