044444444440
511100000115
510001123015
510101000115
510002011115
500101000015
501101010315
500301210115
511111111115
510011100115
500111031115
044444444440