044444444440
511100000115
510001123015
510101000115
510102011105
500101000005
501101010015
500101210115
511111131115
510001100115
500111001115
044444444440