044444444440
511111111115
510001123015
511111111115
510002011105
500101000005
511111011115
500301213115
511111111115
511111111115
511111111115
044444444440