044444444440
511100000115
510001123015
510101000115
510002011105
500101000005
501101010015
500301210115
511100000105
510001100115
500131001115
044444444440